max_time 5000
bomb_time 10
expl_duration 2
expl_range 4
+--------+
|   W   W|
|   W    |
| W W W  |
|        |
|  WWWW  |
|        |
|WWW     |
| W    WW|
|        |
| WWW    |
|        |
|    W   |
|W       |
|    WWW |
|  W     |
|        |
|W  WWW  |
|        |
|EW  W   |
+--------+
