max_time 5000
bomb_time 10
expl_duration 2
expl_range 4
+--------+
|     W  |
| W   W  |
|  W     |
| W   W  |
|        |
|   W    |
|      W |
|  WW    |
| W      |
|      WW|
| W      |
|     WWW|
|  W     |
|        |
| W W W  |
|   W    |
| W   W  |
|   W    |
|E       |
+--------+
